tests/tmp/4_check_maze_solving.txt
#####################
#O........  #   #   #
# #######.##### # # #
#     #...#     # # #
##### #.### ##### # #
# #   #...# #     # #
# # #####.# ##### # #
# #     #.#       # #
# ##### #.######### #
#       #X    #   # #
# ######### # # ### #
#     #     #   #   #
# ##### ####### # ###
# #   # # #   # # # #
### # # # # # # # # #
#   # # #   #   # # #
# ### # ##### ### # #
#   #   #   #   # # #
# # ##### # ##### # #
# #       #         #
#####################
===EOF===
